10 10
##########
#W       #
#        #
#        #
#        #
#        #
#        #
#        #
#        #
##########